[console_scripts]
csv2cve = cve_bin_tool.csv2cve:main
cve-bin-tool = cve_bin_tool.cli:main

[cve_bin_tool.checker]
binutils = cve_bin_tool.checkers.binutils:get_version
bluez = cve_bin_tool.checkers.bluez:get_version
bzip2 = cve_bin_tool.checkers.bzip2:get_version
cups = cve_bin_tool.checkers.cups:get_version
curl = cve_bin_tool.checkers.curl:get_version
expat = cve_bin_tool.checkers.expat:get_version
ffmpeg = cve_bin_tool.checkers.ffmpeg:get_version
gnutls = cve_bin_tool.checkers.gnutls:get_version
gstreamer = cve_bin_tool.checkers.gstreamer:get_version
hostapd = cve_bin_tool.checkers.hostapd:get_version
icu = cve_bin_tool.checkers.icu:get_version
kerberos = cve_bin_tool.checkers.kerberos:get_version
libcurl = cve_bin_tool.checkers.libcurl:get_version
libdb = cve_bin_tool.checkers.libdb:get_version
libgcrypt = cve_bin_tool.checkers.libgcrypt:get_version
libjpeg = cve_bin_tool.checkers.libjpeg:get_version
libnss = cve_bin_tool.checkers.libnss:get_version
libtiff = cve_bin_tool.checkers.libtiff:get_version
lighttpd = cve_bin_tool.checkers.lighttpd:get_version
ncurses = cve_bin_tool.checkers.ncurses:get_version
nessus = cve_bin_tool.checkers.nessus:get_version
nginx = cve_bin_tool.checkers.nginx:get_version
node = cve_bin_tool.checkers.node:get_version
openssh = cve_bin_tool.checkers.openssh:get_version
openssl = cve_bin_tool.checkers.openssl:get_version
openswan = cve_bin_tool.checkers.openswan:get_version
png = cve_bin_tool.checkers.png:get_version
postgresql = cve_bin_tool.checkers.postgresql:get_version
python = cve_bin_tool.checkers.python:get_version
rsyslog = cve_bin_tool.checkers.rsyslog:get_version
sqlite = cve_bin_tool.checkers.sqlite:get_version
strongswan = cve_bin_tool.checkers.strongswan:get_version
syslogng = cve_bin_tool.checkers.syslogng:get_version
systemd = cve_bin_tool.checkers.systemd:get_version
varnish = cve_bin_tool.checkers.varnish:get_version
wireshark = cve_bin_tool.checkers.wireshark:get_version
xerces = cve_bin_tool.checkers.xerces:get_version
xml2 = cve_bin_tool.checkers.xml2:get_version
zlib = cve_bin_tool.checkers.zlib:get_version

