anticipation	anticipation	
bismuth	bismuth	
cat_tilting_head	cat_tilting_head	
dog_tilting_head	dog_tilting_head	
frankensteins_monster	frankensteins_monster	
purple_sunset	purple_sunset	
agender_100	gsr/100/agender_100	
androgyne_100	gsr/100/androgyne_100	
aromantic_100	gsr/100/aromantic_100	
asexual_100	gsr/100/asexual_100	
bear_100	gsr/100/bear_100	
bigender_100	gsr/100/bigender_100	
bisexual_100	gsr/100/bisexual_100	
demienby_100	gsr/100/demienby_100	
demigirl_100	gsr/100/demigirl_100	
demiguy_100	gsr/100/demiguy_100	
demisexual_100	gsr/100/demisexual_100	
enbian_100	gsr/100/enbian_100	
enby_100	gsr/100/enby_100	
genderfluid_100	gsr/100/genderfluid_100	
genderqueer_100	gsr/100/genderqueer_100	
intersex_100	gsr/100/intersex_100	
leather_100	gsr/100/leather_100	
lesbian_100	gsr/100/lesbian_100	
lunaric_100	gsr/100/lunaric_100	
mercuric_100	gsr/100/mercuric_100	
neutrois_100	gsr/100/neutrois_100	
omnisexual_100	gsr/100/omnisexual_100	
pansexual_100	gsr/100/pansexual_100	
poly_100	gsr/100/poly_100	
polysexual_100	gsr/100/polysexual_100	
quoiromantic_100	gsr/100/quoiromantic_100	
solaric_100	gsr/100/solaric_100	
stellaric_100	gsr/100/stellaric_100	
trans_100	gsr/100/trans_100	
agender_bang	gsr/bang/agender_bang	
androgyne_bang	gsr/bang/androgyne_bang	
aromantic_bang	gsr/bang/aromantic_bang	
asexual_bang	gsr/bang/asexual_bang	
bear_bang	gsr/bang/bear_bang	
bigender_bang	gsr/bang/bigender_bang	
bisexual_bang	gsr/bang/bisexual_bang	
demienby_bang	gsr/bang/demienby_bang	
demigirl_bang	gsr/bang/demigirl_bang	
demiguy_bang	gsr/bang/demiguy_bang	
demisexual_bang	gsr/bang/demisexual_bang	
enbian_bang	gsr/bang/enbian_bang	
enby_bang	gsr/bang/enby_bang	
genderfluid_bang	gsr/bang/genderfluid_bang	
genderqueer_bang	gsr/bang/genderqueer_bang	
intersex_bang	gsr/bang/intersex_bang	
leather_bang	gsr/bang/leather_bang	
lesbian_bang	gsr/bang/lesbian_bang	
lunaric_bang	gsr/bang/lunaric_bang	
mercuric_bang	gsr/bang/mercuric_bang	
neutrois_bang	gsr/bang/neutrois_bang	
omnisexual_bang	gsr/bang/omnisexual_bang	
pansexual_bang	gsr/bang/pansexual_bang	
poly_bang	gsr/bang/poly_bang	
polysexual_bang	gsr/bang/polysexual_bang	
quoiromantic_bang	gsr/bang/quoiromantic_bang	
solaric_bang	gsr/bang/solaric_bang	
stellaric_bang	gsr/bang/stellaric_bang	
trans_bang	gsr/bang/trans_bang	
agender_furry	gsr/furry/agender_furry	
androgyne_furry	gsr/furry/androgyne_furry	
aromantic_furry	gsr/furry/aromantic_furry	
asexual_furry	gsr/furry/asexual_furry	
bear_furry	gsr/furry/bear_furry	
bigender_furry	gsr/furry/bigender_furry	
bisexual_furry	gsr/furry/bisexual_furry	
demienby_furry	gsr/furry/demienby_furry	
demigirl_furry	gsr/furry/demigirl_furry	
demiguy_furry	gsr/furry/demiguy_furry	
demisexual_furry	gsr/furry/demisexual_furry	
enbian_furry	gsr/furry/enbian_furry	
enby_furry	gsr/furry/enby_furry	
genderfluid_furry	gsr/furry/genderfluid_furry	
genderqueer_furry	gsr/furry/genderqueer_furry	
intersex_furry	gsr/furry/intersex_furry	
leather_furry	gsr/furry/leather_furry	
lesbian_furry	gsr/furry/lesbian_furry	
lunaric_furry	gsr/furry/lunaric_furry	
mercuric_furry	gsr/furry/mercuric_furry	
neutrois_furry	gsr/furry/neutrois_furry	
omnisexual_furry	gsr/furry/omnisexual_furry	
pansexual_furry	gsr/furry/pansexual_furry	
poly_furry	gsr/furry/poly_furry	
polysexual_furry	gsr/furry/polysexual_furry	
quoiromantic_furry	gsr/furry/quoiromantic_furry	
solaric_furry	gsr/furry/solaric_furry	
stellaric_furry	gsr/furry/stellaric_furry	
trans_furry	gsr/furry/trans_furry	
meeple_agender	gsr/meeple/meeple_agender	
meeple_androgyne	gsr/meeple/meeple_androgyne	
meeple_aromantic	gsr/meeple/meeple_aromantic	
meeple_asexual	gsr/meeple/meeple_asexual	
meeple_bear	gsr/meeple/meeple_bear	
meeple_bigender	gsr/meeple/meeple_bigender	
meeple_bisexual	gsr/meeple/meeple_bisexual	
meeple_demienby	gsr/meeple/meeple_demienby	
meeple_demigirl	gsr/meeple/meeple_demigirl	
meeple_demiguy	gsr/meeple/meeple_demiguy	
meeple_demisexual	gsr/meeple/meeple_demisexual	
meeple_enbian	gsr/meeple/meeple_enbian	
meeple_enby	gsr/meeple/meeple_enby	
meeple_genderfluid	gsr/meeple/meeple_genderfluid	
meeple_genderqueer	gsr/meeple/meeple_genderqueer	
meeple_intersex	gsr/meeple/meeple_intersex	
meeple_leather	gsr/meeple/meeple_leather	
meeple_lesbian	gsr/meeple/meeple_lesbian	
meeple_lunaric	gsr/meeple/meeple_lunaric	
meeple_mercuric	gsr/meeple/meeple_mercuric	
meeple_neutrois	gsr/meeple/meeple_neutrois	
meeple_omnisexual	gsr/meeple/meeple_omnisexual	
meeple_pansexual	gsr/meeple/meeple_pansexual	
meeple_poly	gsr/meeple/meeple_poly	
meeple_polysexual	gsr/meeple/meeple_polysexual	
meeple_pride	gsr/meeple/meeple_pride	
meeple_quoiromantic	gsr/meeple/meeple_quoiromantic	
meeple_solaric	gsr/meeple/meeple_solaric	
meeple_stellaric	gsr/meeple/meeple_stellaric	
meeple_trans	gsr/meeple/meeple_trans	
agender_sweat_drops	gsr/sweat_drops/agender_sweat_drops	
androgyne_sweat_drops	gsr/sweat_drops/androgyne_sweat_drops	
aromantic_sweat_drops	gsr/sweat_drops/aromantic_sweat_drops	
asexual_sweat_drops	gsr/sweat_drops/asexual_sweat_drops	
bear_sweat_drops	gsr/sweat_drops/bear_sweat_drops	
bigender_sweat_drops	gsr/sweat_drops/bigender_sweat_drops	
bisexual_sweat_drops	gsr/sweat_drops/bisexual_sweat_drops	
demienby_sweat_drops	gsr/sweat_drops/demienby_sweat_drops	
demigirl_sweat_drops	gsr/sweat_drops/demigirl_sweat_drops	
demiguy_sweat_drops	gsr/sweat_drops/demiguy_sweat_drops	
demisexual_sweat_drops	gsr/sweat_drops/demisexual_sweat_drops	
enbian_sweat_drops	gsr/sweat_drops/enbian_sweat_drops	
enby_sweat_drops	gsr/sweat_drops/enby_sweat_drops	
genderfluid_sweat_drops	gsr/sweat_drops/genderfluid_sweat_drops	
genderqueer_sweat_drops	gsr/sweat_drops/genderqueer_sweat_drops	
intersex_sweat_drops	gsr/sweat_drops/intersex_sweat_drops	
leather_sweat_drops	gsr/sweat_drops/leather_sweat_drops	
lesbian_sweat_drops	gsr/sweat_drops/lesbian_sweat_drops	
lunaric_sweat_drops	gsr/sweat_drops/lunaric_sweat_drops	
mercuric_sweat_drops	gsr/sweat_drops/mercuric_sweat_drops	
neutrois_sweat_drops	gsr/sweat_drops/neutrois_sweat_drops	
omnisexual_sweat_drops	gsr/sweat_drops/omnisexual_sweat_drops	
pansexual_sweat_drops	gsr/sweat_drops/pansexual_sweat_drops	
poly_sweat_drops	gsr/sweat_drops/poly_sweat_drops	
polysexual_sweat_drops	gsr/sweat_drops/polysexual_sweat_drops	
pride_sweat_drops	gsr/sweat_drops/pride_sweat_drops	
quoiromantic_sweat_drops	gsr/sweat_drops/quoiromantic_sweat_drops	
solaric_sweat_drops	gsr/sweat_drops/solaric_sweat_drops	
stellaric_sweat_drops	gsr/sweat_drops/stellaric_sweat_drops	
trans_sweat_drops	gsr/sweat_drops/trans_sweat_drops	
avocado_toast	items/avocado_toast	
cursed_eggplant	items/cursed_eggplant	
no_ice	items/no_ice	
trainsgender	items/trainsgender	
cursed_eyebrows	smileys/cursed_eyebrows	
rave	smileys/rave	
civil	symbols/civil	
douze_points	symbols/douze_points	
s	symbols/s	
cursed_think	thinks/cursed_think	
double_thincc	thinks/double_thincc	
imp_think	thinks/imp_think	
shark_think	thinks/shark_think	
think_disappointed	thinks/think_disappointed	
think_mind_blown	thinks/think_mind_blown	
think_shit	thinks/think_shit	
think_smirk	thinks/think_smirk	
think_starry_eyes	thinks/think_starry_eyes	
think_unamused	thinks/think_unamused	
thinking_fire	thinks/thinking_fire	
thinktink	thinks/thinktink	
throunking	thinks/throunking	
trans_thinking	thinks/trans_thinking	
weed_think	thinks/weed_think	
